1111111111111111111111111111111111111
1P001C1000000000001000000000000000001
1000101000000000000000001000000000001
100C000001000000000000011000000000001
1C000000110C0000000000011000001000001
1000000000000000000000000000000000001
100000000000C0000000000000000C1000001
1000000000000000000000001000010000001
10000000010000000001000000000C0000001
100C000000000000000000000000000000001
1000000000000000001C10000000000000001
1000010C00000000000C00000000000000001
1000010000000000000000000100010100111
100C00000000000000C00000011C01E100101
1111111111111111111111111111111111111