10C0P111
10000111
111111101
11111111
111111111
11111111
11111111