1111111111111
1000000010001
1000P10010E01
1001110111001
1C00000011001
1111111111111