111111111111
1PECCCCCCCC1
111111111111