1111111111111
10000C0000001
1000P00000E01
100C000111000
1C000000110C1
1111111111111