1111111
10100C1
1010101
10P01E1
1111111